XXXXXXXXXXXXXXXXXXXXX
XXXXXXXXXXXXXXXXXXXXX
XXXXXXXXXXXXXXXXXXXXX
XXPPPPPPPPPPPPPPPPPXX
XXI            PP PXX
XXP     P   PP   GPXX
XXPPPPPPP PGPPP PPPXX
XXP     P P   P   PXX
XXPPPPP P PPP PPPPPXX
XXP   D           PXX
XXPP PPPPPPPPPPPPPPXX
XXP       G       PXX
XXPP PPPPPPPPP PPPPXX
XXP          P D  PXX
XXPP PP P P PPPPP PXX
XXP G P P P   DPP PXX
XXPPPPPPPPPPPPPPPSPXX
XXXXXXXXXXXXXXXXXXXXX
XXXXXXXXXXXXXXXXXXXXX
XXXXXXXXXXXXXXXXXXXXX
