PPPPPPPPPPPPPPPPPPPPP
I        P         GP
P PPPPPP   PPPPPPPPPP
P      PP PP        P
PPPPPP  P    PPPPPPPP
P      GP PPPP     GP
P PPPPPPP PGPPP PPPPP
P       P P   P     P
PPPPPPP P PPP PPPP PP
P     D             P
P PPPPPPPPPPPPPPPPPPP
P         G       P P
PPPPPPPPPPPPPP PPPP P
P            D      P
P PP PP PPP PPPPPPPPP
P P   P P P PPGPP PPP
P PPGPP P        D PP
P PPPPP PPPPPPPPP PPP
P         P         P
PPPPPPPPPPPPPPPPPPPSP
